0,0,450,0,350,0,0,0,1,1,1,10,0
2,2,5000,0,5000,0,0,0,11000,1,11000,0,0
2,2,50,50,50,0,0,0,100,100,100,0,0
2,2,150,50,50,0,0,0,100,100,100,0,0
2,2,50,150,50,0,0,0,100,100,100,0,0
2,2,150,150,50,0,0,0,100,100,100,0,0
2,2,50,50,150,0,0,0,100,100,100,0,0
2,2,50,150,150,0,0,0,100,100,100,0,0
